[
      {
    "name": "n",
      "layout": [
        {
          "exits": "1000",
          "row_1": "####.####",
          "row_2": "#..#.#..#",
          "row_3": "#.......#",
          "row_4": "#.......#",
          "row_5": "#.......#",
          "row_6": "#.......#",
          "row_7": "#.......#",
          "row_8": "#.......#",
          "row_9": "#########"
        }
      ]
  },
      {
    "name": "e",
      "layout": [
        {
          "exits": "0100",
          "row_1": "#########",
          "row_2": "#.......#",
          "row_3": "#.......#",
          "row_4": "#......##",
          "row_5": "#........",
          "row_6": "#......##",
          "row_7": "#.......#",
          "row_8": "#.......#",
          "row_9": "#########"
        }
      ]
  },
      {
    "name": "s",
      "layout": [
        {
          "exits": "0010",
          "row_1": "#########",
          "row_2": "#.......#",
          "row_3": "#.......#",
          "row_4": "#.......#",
          "row_5": "#.......#",
          "row_6": "#.......#",
          "row_7": "#.......#",
          "row_8": "#..#.#..#",
          "row_9": "####.####"
        }
      ]
  },
      {
    "name": "w",
      "layout": [
        {
          "exits": "0001",
          "row_1": "#########",
          "row_2": "#.......#",
          "row_3": "#.......#",
          "row_4": "##......#",
          "row_5": "........#",
          "row_6": "##......#",
          "row_7": "#.......#",
          "row_8": "#.......#",
          "row_9": "#########"
        }
      ]
  },
      {
      "name": "ne",
        "layout": [
          {
            "exits": "1100",
          "row_1": "####.####",
          "row_2": "#..#.#..#",
          "row_3": "#.......#",
          "row_4": "#......##",
          "row_5": "#........",
          "row_6": "#......##",
          "row_7": "#.......#",
          "row_8": "#.......#",
          "row_9": "#########"
          }
        ]
    },
      {
      "name": "nw",
        "layout": [
          {
            "exits": "1001",
          "row_1": "####.####",
          "row_2": "#..#.#..#",
          "row_3": "#.......#",
          "row_4": "##......#",
          "row_5": "........#",
          "row_6": "##......#",
          "row_7": "#.......#",
          "row_8": "#.......#",
          "row_9": "#########"
          }
        ]
    },
      {
      "name": "se",
        "layout": [
          {
            "exits": "0110",
          "row_1": "#########",
          "row_2": "#.......#",
          "row_3": "#.......#",
          "row_4": "#......##",
          "row_5": "#........",
          "row_6": "#......##",
          "row_7": "#.......#",
          "row_8": "#..#.#..#",
          "row_9": "####.####"
          }
        ]
    },
      {
      "name": "sw",
        "layout": [
          {
            "exits": "0011",
          "row_1": "#########",
          "row_2": "#.......#",
          "row_3": "#.......#",
          "row_4": "##......#",
          "row_5": "........#",
          "row_6": "##......#",
          "row_7": "#.......#",
          "row_8": "#..#.#..#",
          "row_9": "####.####"
          }
        ]
    },
      {
      "name": "ew",
        "layout": [
          {
            "exits": "0101",
          "row_1": "#########",
          "row_2": "#.......#",
          "row_3": "#.......#",
          "row_4": "##.....##",
          "row_5": ".........",
          "row_6": "##.....##",
          "row_7": "#.......#",
          "row_8": "#.......#",
          "row_9": "#########"
          }
        ]
    },
      {
      "name": "nesw",
        "layout": [
          {
            "exits": "1111",
          "row_1": "####.####",
          "row_2": "#..#.#..#",
          "row_3": "#.......#",
          "row_4": "##.....##",
          "row_5": ".........",
          "row_6": "##.....##",
          "row_7": "#.......#",
          "row_8": "#..#.#..#",
          "row_9": "####.####"
          }
        ]
    },{
      "name": "ns",
        "layout": [
          {
            "exits": "1010",
          "row_1": "####.####",
          "row_2": "#..#.#..#",
          "row_3": "#.......#",
          "row_4": "#.......#",
          "row_5": "#.......#",
          "row_6": "#.......#",
          "row_7": "#.......#",
          "row_8": "#..#.#..#",
          "row_9": "####.####"
          }
        ]
    },
      {
      "name": "ne-corr-thin",
        "layout": [
          {
            "exits": "1100",
          "row_1": "   #.#   ",
          "row_2": "   #.#   ",
          "row_3": "   #.#   ",
          "row_4": "   #.####",
          "row_5": "   #.....",
          "row_6": "   ######",
          "row_7": "         ",
          "row_8": "         ",
          "row_9": "         "
          }
        ]
    },
      {
      "name": "nw-corr-thin",
        "layout": [
          {
            "exits": "1001",
          "row_1": "   #.#   ",
          "row_2": "   #.#   ",
          "row_3": "   #.#   ",
          "row_4": "####.#   ",
          "row_5": ".....#   ",
          "row_6": "######   ",
          "row_7": "         ",
          "row_8": "         ",
          "row_9": "         "
          }
        ]
    },
      {
      "name": "se-corr-thin",
        "layout": [
          {
            "exits": "0110",
          "row_1": "         ",
          "row_2": "         ",
          "row_3": "         ",
          "row_4": "   ######",
          "row_5": "   #.....",
          "row_6": "   #.####",
          "row_7": "   #.#   ",
          "row_8": "   #.#   ",
          "row_9": "   #.#   "
          }
        ]
    },
      {
      "name": "sw-corr-thin",
        "layout": [
          {
            "exits": "0011",
          "row_1": "         ",
          "row_2": "         ",
          "row_3": "         ",
          "row_4": "######   ",
          "row_5": ".....#   ",
          "row_6": "####.#   ",
          "row_7": "   #.#   ",
          "row_8": "   #.#   ",
          "row_9": "   #.#   "
          }
        ]
    },
      {
      "name": "ns-corr-thin",
        "layout": [
          {
            "exits": "1010",
          "row_1": "   #.#   ",
          "row_2": "   #.#   ",
          "row_3": "   #.#   ",
          "row_4": "   #.#   ",
          "row_5": "   #.#   ",
          "row_6": "   #.#   ",
          "row_7": "   #.#   ",
          "row_8": "   #.#   ",
          "row_9": "   #.#   "
          }
        ]
    },
      {
    "name": "e-bubble",
      "layout": [
        {
          "exits": "0100",
          "row_1": "   ###   ",
          "row_2": "  #...#  ",
          "row_3": " #.....# ",
          "row_4": " #.....##",
          "row_5": " #.......",
          "row_6": "  #....##",
          "row_7": "   #....#",
          "row_8": "   #....#",
          "row_9": "   ######"
        }
      ]
  }
]